30 30 30 30 30 30 30 30 30 30 30 30 30 30 30 30 30 30 30 30 30 30 30 30 30 30 30 30 30 30 30 30 30 30 30 30 30 30 30 30 30 30 30 30 30 30 30 30 30 30
30 31 31 11 09 09 09 09 09 09 09 09 09 09 09 09 09 09 11 09 09 09 09 09 09 09 09 11 09 09 09 09 09 09 09 09 09 09 09 09 09 09 09 09 09 09 09 09 09 30
30 09 09 09 09 09 09 09 09 09 31 09 09 09 09 31 13 09 09 09 09 09 11 09 09 09 09 09 09 09 09 09 09 09 09 09 09 09 09 11 09 09 09 09 13 09 09 09 16 30
30 12 11 09 09 09 11 09 12 09 09 09 09 09 09 11 09 09 12 09 10 15 09 09 31 09 09 14 09 09 09 09 09 09 11 09 09 09 31 14 09 09 12 09 09 09 09 09 09 30
30 09 09 09 09 09 09 09 09 09 09 09 09 09 09 09 09 09 09 09 09 09 31 09 09 09 09 09 09 31 09 11 09 09 09 09 09 31 09 09 09 09 09 09 09 09 11 09 09 30
30 09 09 09 31 09 09 09 09 09 09 11 09 15 09 09 09 09 09 11 09 09 09 09 11 09 09 11 09 09 15 09 09 09 13 18 20 20 20 20 20 20 20 20 19 16 09 09 09 30
30 09 09 09 09 09 09 09 09 11 09 09 09 09 09 09 14 09 09 09 09 09 09 09 09 09 09 09 15 10 09 09 09 09 09 21 17 17 17 27 17 17 17 26 22 31 09 09 09 30
30 09 31 09 09 11 12 09 09 11 31 09 09 09 09 09 09 11 09 09 09 09 09 09 13 09 09 09 09 09 03 01 02 11 09 21 17 17 17 17 17 17 17 17 22 09 09 09 09 30
30 09 09 09 09 09 03 01 01 01 01 01 02 09 09 09 09 09 09 09 09 09 09 09 09 11 09 09 09 09 04 00 05 09 09 21 17 17 29 17 17 17 17 17 22 09 09 11 09 30
30 09 09 09 09 09 04 00 00 00 00 00 05 11 09 09 09 15 09 13 09 09 11 03 01 01 01 01 01 01 35 00 05 09 09 21 17 17 17 17 17 17 17 17 22 11 31 09 09 30
30 09 12 09 09 09 04 00 00 00 00 00 05 09 09 09 09 09 09 09 09 09 09 04 00 00 00 00 00 00 00 00 05 09 09 21 17 17 17 17 26 17 17 17 22 09 16 31 09 30
30 09 09 31 11 09 04 00 00 00 00 00 05 09 31 31 09 09 09 09 11 09 09 04 00 32 08 08 08 08 33 00 05 14 09 21 27 17 17 17 17 17 17 17 22 09 12 09 09 30
30 31 09 09 09 09 04 00 00 00 00 00 05 09 09 09 09 09 09 09 09 09 09 04 00 05 11 09 09 12 04 00 05 09 09 21 17 17 29 17 17 17 17 17 22 09 11 09 09 30
30 11 09 10 09 09 07 08 08 08 33 00 05 09 09 09 11 31 09 09 09 09 09 04 00 05 09 09 09 09 07 08 06 09 09 21 17 17 17 28 17 17 17 17 22 09 09 09 09 30
30 09 09 09 09 09 09 15 09 09 04 00 05 09 09 09 09 09 11 09 09 09 09 04 00 05 09 09 09 12 09 13 09 09 11 21 26 17 17 17 17 17 17 27 22 09 09 09 09 30
30 09 09 09 09 31 09 09 09 09 04 00 05 11 09 09 09 09 09 15 09 09 11 04 00 05 09 11 09 09 09 09 09 11 09 23 25 25 25 25 25 25 25 25 24 09 09 09 11 30
30 09 09 31 09 09 09 09 09 09 04 00 05 09 10 09 09 09 11 31 09 09 09 04 00 05 09 09 31 09 09 09 09 31 09 09 09 09 09 31 09 11 09 09 09 09 09 31 09 30
30 09 09 11 09 09 09 09 09 31 04 00 05 09 09 16 09 31 09 09 09 09 09 04 00 05 09 09 09 31 09 09 11 09 09 09 09 09 11 12 09 09 09 09 09 11 09 09 09 30
30 09 16 09 09 09 09 09 09 13 04 00 05 11 09 09 12 09 09 09 14 09 09 04 00 05 12 09 31 09 09 09 09 09 09 09 09 12 09 09 09 09 09 09 09 09 09 09 09 30
30 09 31 09 09 11 09 31 09 09 04 00 05 09 09 09 09 09 09 09 09 11 03 35 00 34 02 09 14 09 09 09 09 09 09 11 09 15 09 09 11 09 09 09 09 09 14 09 09 30
30 14 09 09 09 09 09 09 09 16 04 00 05 09 09 11 09 09 31 09 09 03 35 00 00 00 34 02 09 09 11 09 31 09 09 09 09 09 09 09 09 09 09 09 31 09 09 09 09 30
30 09 09 09 09 09 15 09 11 11 04 00 05 12 09 09 09 11 09 09 03 35 00 00 00 00 00 34 02 09 09 09 09 09 09 09 09 09 11 09 09 09 09 11 09 09 09 11 09 30
30 09 09 09 09 09 09 09 09 11 04 00 34 01 01 01 01 01 01 01 35 00 00 00 00 00 00 00 05 09 16 09 16 15 09 09 09 09 09 09 09 09 09 09 09 09 31 09 09 30
30 09 11 09 09 09 09 09 09 09 04 00 00 00 00 00 00 00 00 00 00 00 00 00 00 00 00 00 05 09 09 09 09 09 11 09 09 31 09 09 09 31 09 09 09 09 13 09 09 30
30 09 09 09 09 12 09 09 09 09 07 08 08 08 08 08 08 08 08 08 33 00 00 00 00 00 00 00 05 31 11 09 09 09 09 09 09 09 09 10 09 09 15 09 09 10 09 09 09 30
30 09 15 09 09 09 09 09 09 09 09 09 11 09 09 16 09 09 09 11 07 33 00 00 00 00 00 32 06 09 09 09 09 09 09 09 09 09 09 09 09 09 31 09 09 12 09 09 09 30
30 09 09 13 09 09 09 09 09 09 31 09 09 09 31 09 09 09 16 09 09 07 33 00 00 00 32 06 09 09 10 09 09 09 09 31 09 09 09 09 09 09 09 09 09 09 09 09 09 30
30 09 31 09 09 09 16 09 11 09 09 09 09 09 09 09 09 09 09 13 09 11 07 33 00 32 06 09 09 09 09 09 11 14 09 09 09 09 11 09 09 09 09 09 09 09 31 09 09 30
30 31 09 11 09 09 09 09 09 09 09 09 09 11 09 09 31 09 11 09 09 09 09 04 00 05 09 09 16 09 09 09 09 09 09 09 09 09 09 09 09 09 09 09 11 09 09 09 09 30
30 09 09 09 09 12 09 09 09 09 09 09 09 09 09 09 09 09 09 09 09 10 09 04 00 05 09 09 13 09 11 09 12 09 09 09 09 09 09 09 09 09 09 09 09 09 09 09 09 30
30 09 09 09 09 09 09 09 09 11 09 09 15 09 09 09 11 09 09 15 09 09 09 04 00 05 11 09 09 09 09 09 31 09 09 09 09 09 09 16 15 09 09 09 09 14 09 11 09 30
30 09 09 09 11 09 09 09 31 09 09 09 12 09 09 09 09 09 09 09 09 11 09 04 00 05 09 09 09 09 09 09 09 31 31 09 11 09 09 09 09 09 09 09 09 09 09 09 09 30
30 11 09 31 09 09 09 09 09 10 09 09 09 09 16 09 09 09 12 09 09 09 09 04 00 05 16 09 11 09 09 09 09 09 13 09 09 09 31 09 09 09 09 09 09 09 09 09 09 30
30 09 09 09 09 09 14 09 09 09 09 09 09 09 09 09 31 09 09 09 09 09 11 04 00 05 09 09 09 09 09 09 31 09 09 09 09 09 09 09 09 09 11 09 09 09 09 09 09 30
30 09 09 10 09 09 09 09 09 09 09 09 09 11 09 09 09 09 09 09 11 09 09 04 00 05 16 15 09 09 09 09 09 11 09 09 09 09 09 09 09 09 09 09 09 11 09 09 09 30
30 09 09 09 09 31 09 09 11 11 09 12 09 09 09 09 09 09 09 09 09 09 09 04 00 05 09 31 09 09 09 16 09 09 09 09 09 11 09 09 09 09 09 09 09 09 09 09 09 30
30 13 09 09 09 09 09 31 09 09 09 09 09 09 09 31 09 11 09 09 16 09 09 04 00 05 09 09 11 09 09 09 09 09 09 09 09 09 09 12 09 09 09 09 09 31 09 11 09 30
30 09 09 11 09 09 09 09 16 15 11 09 09 09 14 09 09 09 09 31 09 09 09 04 00 05 09 09 09 09 09 31 09 09 09 09 09 09 09 09 09 09 09 09 15 09 09 09 09 30
30 11 31 12 03 01 01 01 01 01 01 01 01 01 01 01 01 01 01 01 01 01 01 35 00 05 09 09 09 09 09 09 09 09 09 09 09 14 09 09 09 13 09 09 09 11 09 10 09 30
30 09 09 09 04 00 00 00 00 00 00 00 00 00 00 00 00 00 00 00 00 00 00 00 00 05 11 09 09 09 09 09 11 09 09 10 09 09 09 09 09 09 09 09 09 09 09 09 09 30
30 09 11 09 04 00 00 32 08 08 08 08 08 08 08 08 08 08 08 08 08 08 08 33 00 05 09 09 09 09 09 09 09 09 09 09 09 09 16 09 09 09 12 09 09 09 09 09 09 30
30 09 03 01 35 00 00 34 01 02 09 13 09 09 09 09 09 09 09 09 09 09 09 04 00 05 09 09 09 09 09 09 09 11 09 09 09 09 09 11 31 09 09 09 09 09 09 11 09 30
30 31 04 00 00 00 00 00 00 05 09 09 09 09 09 11 09 09 11 09 09 09 11 04 00 05 09 09 09 11 09 09 09 09 03 01 02 15 31 09 09 09 09 11 09 09 09 09 09 30
30 09 07 08 08 08 08 08 08 06 09 31 09 09 09 09 09 09 09 09 09 09 09 04 00 34 01 01 01 01 01 01 01 01 35 00 05 11 09 09 09 09 15 09 09 09 09 09 09 30
30 09 18 20 20 20 20 20 20 19 09 15 09 09 11 09 09 11 09 09 09 11 09 04 00 00 00 00 00 00 00 00 00 00 00 00 05 09 09 09 11 09 09 09 15 09 09 09 09 30
30 09 21 27 17 29 17 17 17 22 09 09 31 09 31 09 09 09 09 09 09 09 09 07 08 08 08 08 08 08 08 08 08 08 33 00 05 09 09 09 09 31 09 09 09 09 16 09 09 30
30 09 21 17 17 17 28 17 26 22 09 09 09 09 09 09 09 09 14 09 09 15 09 09 11 09 09 09 11 09 09 09 09 09 07 08 06 16 09 09 09 09 11 09 09 09 12 31 09 30
30 12 23 25 25 25 25 25 25 24 09 11 09 09 09 09 11 09 09 09 11 09 09 11 09 09 10 09 13 09 09 11 09 09 09 09 09 11 09 09 09 09 09 09 09 09 09 13 11 30
30 31 09 11 14 11 09 09 12 16 31 09 09 09 09 13 09 09 11 15 09 09 15 09 09 11 09 09 11 09 11 09 09 09 16 09 12 09 31 09 12 09 09 09 11 11 09 09 09 30
30 30 30 30 30 30 30 30 30 30 30 30 30 30 30 30 30 30 30 30 30 30 30 30 30 30 30 30 30 30 30 30 30 30 30 30 30 30 30 30 30 30 30 30 30 30 30 30 30 30